##############################
#S...........................#
#..#########.......#######...#
#..#.......#.......#.....#...#
#..#..###..#.......#..#..#...#
#..#..#.#..#.......#..#..#...#
#..####.####.......####.##...#
#............................#
#..#########.......#######...#
#..#.......#.......#.....#...#
#..#..###..#..###..#..#..#...#
#..#..#.#..L..#.#..D..#..#...#
#..####.#######.#######.##...#
#............................#
#..#########.......#######...#
#..#.......#.......#.....#...#
#..#..###..#.......#..#..#...#
#..#..#.#..#.......#..#..#...#
#..####.####.......####.##...#
#............................#
#..#########.......#######...#
#..#.......#.......#.....#...#
#..#..###..#.......#..#..#...#
#..#..#.#..#.......#..#..#...#
#..####.####.......####.##...#
#............................#
#..#########.......#######...#
#..#.......#.......#.....#...#
#..........................>.#
##############################
