##############################
#<.....#.....#.....#.........#
######.#.###.#.###.#.#######.#
#......#.#.#...#.#.#.......#.#
#.######.#.#####.#.#######.#.#
#.#......#.......#.......#.#.#
#.#.######.#####.#######.#.#.#
#.#.#......#...#.......#.#.#.#
#.#.#.######.#.#######.#.#.#.#
#.#.#.#......#.......#.#.#.#.#
#.#.#.#.######.#####.#.#.#.#.#
#.#.#.#.#......#...#.#.#.#.#.#
#.#.#.#.#.######.#.#.#.#.#.#.#
#.#.#.#.#.#......#.#.#.#.#.#.#
#.#.#.#.#.#.######.#.#.#.#.#.#
#.#.#.#.#.#........#.#.#.#.#.#
#.#.#.#.#.##########.#.#.#.#.#
#.#.#.#.#............#.#.#.#.#
#.#.#.#.##############.#.#.#.#
#.#.#.#................#.#.#.#
#.#.#.##################.#.#.#
#.#.#....................#.#.#
#.#.######################.#.#
#.#........................#.#
#.##########################.#
#............................#
#.##########################.#
#..........................>.#
#.##########################.#
##############################
