##############################
#<.#...#...#...#...#...#...#.#
#..#...#...#...#...#...#...#.#
#............................#
#..#...#...#...#...#...#...#.#
#..#...#...#...#...#...#...#.#
#............................#
#..#...#...#...#...#...#...#.#
#..#...#...#...#...#...#...#.#
#............................#
#..#...#...#...#...#...#...#.#
#..#...#...#...#...#...#...#.#
#............................#
#..#...#...#...#...#...#...#.#
#..#...#...#...#...#...#...#.#
#............................#
#..#...#...#...#...#...#...#.#
#..#...#...#...#...#...#...#.#
#............................#
#..#...#...#...#...#...#...#.#
#..#...#...#...#...#...#...#.#
#............................#
#..#...#...#...#...#...#...#.#
#..#...#...#...#...#...#...#.#
#............................#
#..#...#...#...#...#...#...#.#
#..#...#...#...#...#...#...#.#
#............................#
#..#...#...#...#...#...#...>.#
##############################
