##############################
#<.............#.............#
#..............#.............#
#..............#.............#
#..............#.............#
#..............#.............#
#..............#.............#
#..............#.............#
#..............#.............#
#..............#.............#
#..............#.............#
#..............#.............#
#..............D.............#
#..............#.............#
#..............#.............#
########D######.#D############
#..............#.............#
#..............#.............#
#..............D.............#
#..............#.............#
#..............#.............#
#..............#.............#
#..............#.............#
#..............#.............#
#..............#.............#
#..............#.............#
#..............#.............#
#..............#.............#
#..............#...........>.#
##############################
