##############################
#<...........................#
#............................#
#............................#
#............................#
#............................#
#......################......#
#......#..............#......#
#......#..............#......#
#......#..............#......#
#......#..............#......#
#......#..............#......#
#......#..............#......#
#......#..............#......#
#......D..............D......#
#......#..............#......#
#......#..............#......#
#......#..............#......#
#......#..............#......#
#......#..............#......#
#......#..............#......#
#......################......#
#............................#
#............................#
#............................#
#............................#
#............................#
#............................#
#..........................>.#
##############################
