##############################
#<...........................#
#..#########.......#######...#
#..#.......#.......#.....#...#
#..#..###..D.......#..#..#...#
#..#..#.#..#.......#..#..#...#
#..####.####.......####.##...#
#............................#
#..#########.......#######...#
#..#.......#.......#.....#...#
#..#..###..#..###..#..#..#...#
#..#..#.#..D..#.#..D..#..#...#
#..####.#######.#######.##...#
#............................#
#..#########.......#######...#
#..#.......#.......#.....#...#
#..#..###..#.......#..#..#...#
#..#..#.#..#.......#..#..#...#
#..####.####.......####.##...#
#............................#
#..#########.......#######...#
#..#.......#.......#.....#...#
#..#..###..#.......#..#..#...#
#..#..#.#..#.......#..#..#...#
#..####.####.......####.##...#
#............................#
#..#########.......#######...#
#..#.......#.......#.....#...#
#..........................>.#
##############################
