##########################################
##############...........###....####.....#
###...<..#####...........###....####.....#
###......#####...........###....####.....#
###...S..DDD.......................D.....#
###......#####...........###....####.....#
###......#####...........###....####.....#
#######.##########..##########.#######.###
#######.##########..##########.#######.###
##..........###......######......##......#
##..........###......######......##......#
##.......................................#
##...................######......##......#
##..........###......######......#########
##..........###############......#########
##..........###############......#########
####.#####################################
####.#####################################
#.......#############.....################
#.......#############.....###............#
#.......##.......####.....###............#
#.......##.......####.....###............#
#.........................###............#
#...................................######
#.......##.......####.....#########.######
#.......##.......####.....#########D######
#.......###########################.######
#.......###########################.######
####.##############################.######
####.##############################.######
####.#######.......##.....#########.######
#......#####.......##.....#########.######
#......#####.......##.....#########.######
#......#####..............#########.######
#......#####.......##.....#########.######
#......#####.......##.....####...........#
#...............#####.....####...........#
#......##############.....####...........#
#......##############.....####...........#
#......##############.....####.....>.....#
#......###################################
##########################################
