################################
################################
##..<.#################......###
##....#################......###
##..S........................###
##....#####.........###......###
##....#####.........###......###
#####.#####.........###......###
#####.#####.........###......###
#####.#####.........###......###
#####.#################......###
#####.#################......###
#####.#################......###
#####.##########################
#####.##########################
##......####........############
##......####........####.......#
##......####........####.......#
##......####.........D.........#
##......####........####.......#
##......####........####.......#
####.##########..###########.###
####.##########..###########.###
####.##########..###########.###
#.......#######..###########.###
#.......##...........#######.###
#.......##...........#####.....#
#....................#####.....#
#.......##...........#####.....#
#.......##...........#####.....#
##########...........#####..>..#
################################
