##############################
#<...........................#
#............................#
#...####..............####...#
#...#..#..............#..#...#
#...####..............####...#
#............................#
#............................#
#............................#
#............................#
#............................#
#............................#
#...........######...........#
#...........#....#...........#
#...........#....#...........#
#...........#....#...........#
#...........######...........#
#............................#
#............................#
#............................#
#............................#
#............................#
#............................#
#...####..............####...#
#...#..#..............#..#...#
#...####..............####...#
#............................#
#............................#
#..........................>.#
##############################
