##############################
#<...........................#
##########################...#
#........................#...#
#...####################.#...#
#...#..................#.#...#
#...#.################.#.#...#
#...#.#..............#.#.#...#
#...#.#.############.#.#.#...#
#...#.#.#..........#.#.#.#...#
#...#.#.#.########.#.#.#.#...#
#...#.#.#.#......#.#.#.#.#...#
#...#.#.#.#.####.#.#.#.#.#...#
#...#.#.#.#.#..#.#.#.#.#.#...#
#...#.#.#.#.#..#.#.#.#.#.#...#
#...#.#.#.#.#..#.#.#.#.#.#...#
#...#.#.#.#.####.#.#.#.#.#...#
#...#.#.#.#......#.#.#.#.#...#
#...#.#.#.########.#.#.#.#...#
#...#.#.#..........#.#.#.#...#
#...#.#.############.#.#.#...#
#...#.#..............#.#.#...#
#...#.################.#.#...#
#...#..................#.#...#
#...####################.#...#
#........................#...#
##########################...#
#............................#
#..........................>.#
##############################
