##############################
#<.#.................#.......#
#.##.#######.#######.#.#####.#
#....#.....#.#.....#.#.#...#.#
#.####.###.#.#.###.#.#.#.#.#.#
#.#..#.#.#.#.#.#...#.#.#.#.#.#
#.#.##.#.#.#.#.#####.#.#.#.#.#
#.#....#.#.#.#.......#...#...#
#.######.#.###.#######.#####.#
#.#......#.#...#.......#...#.#
#.#.######.#.###.#######.#.#.#
#.#......#.#.#.........#.#.#.#
#.######.#.#.#####.###.#.#.#.#
#.#....#.#.#.....#...#.#.#.#.#
#.#.##.#.#.#####.###.#.#.#.#.#
#.#..#.#.#.....#...#.#.#.#.#.#
#.####.#.#####.###.#.#.#.#.#.#
#......#.....#.....#.#.#...#.#
#.##########.#######.#.#####.#
#.#........#.........#.......#
#.#.######.###########.#####.#
#.#.#....#.#...........#...#.#
#.#.#.##.#.#.#######.#.#.#.#.#
#...#..#.#.#.#.....#.#.#.#.#.#
######.#.#.#.#.###.#.#.#.#.#.#
#......#.#.#.#...#.#.#.#.#.#.#
#.######.#.#.###.#.#.#.#.#.###
#........#.......#...#.......#
#.########.###########.#####>#
##############################
